##################################################
%                                          F     %
%                                                %
%                                                %
%                                                %
%                                                %
%                                                %
%                                                %
%                                                %
%                                                %
%                                                %
%                                                %
%                                                %
%                                                %
%                                                %
%                                                %
%                                                %
%                                                %
%                                                %
%                                                %
%                                                %
%                                                %
%                                                %
%                                                %
##################################################